10 10
S---L ----
 L--L ----
 L---T ---
 L--L+----
 L--L+----
 L--L+----
 L--L+----
 L--L+----
 L--L+----
 L--L+----